10 10
5 5
1 1 1 1 1 1 1 1 1 1
1 1 17 13 13 13 13 16 1 1
1 14 0 2 0 0 7 0 14 1
1 11 2 0 2 2 4 2 11 1
1 11 10 6 6 6 5 9 11 1
1 11 3 3 2 2 4 0 11 1
1 11 2 3 2 2 4 2 11 1
1 15 0 2 0 0 8 0 15 1
1 1 17 13 13 13 13 16 1 1
1 1 1 1 1 1 1 1 1 1