10 10
4 4
1 1 1 1 1 1 1 1 1 1
1 1 11 12 12 12 12 11 1 1
1 11 11 2 0 0 6 11 11 1
1 10 2 0 2 2 3 2 10 1
1 10 9 5 5 5 4 8 10 1
1 10 0 2 2 2 3 0 10 1
1 10 2 0 2 2 3 2 10 1
1 11 11 2 0 0 7 11 11 1
1 1 11 12 12 12 12 11 1 1
1 1 1 1 1 1 1 1 1 1