5 5
3 3
3 3 3 3 3
3 1 0 1 3
3 0 4 0 3
3 1 0 1 3
3 3 3 3 3